Name: Alexander, Ryan	Score: 0	Grad? false
Name: Allen, Jane	Score: 0	Grad? false
Name: Allison, Melissa	Score: 0	Grad? false
Name: Benson, Sam	Score: 0	Grad? false
Name: Black, Lisa	Score: 0	Grad? false
Name: Black, Thad	Score: 0	Grad? false
Name: Boole, Janie	Score: 0	Grad? false
Name: Bush, Lisa	Score: 0	Grad? false
Name: Bush, Tony	Score: 0	Grad? false
Name: Cain, Jamie	Score: 0	Grad? false
Name: Cain, Janie	Score: 0	Grad? false
Name: Chambers, Adrian	Score: 0	Grad? false
Name: Chandler, Janie	Score: 0	Grad? false
Name: Cook, Andrew	Score: 0	Grad? false
Name: Cook, Lisa	Score: 0	Grad? false
Name: Cook, Lisa	Score: 0	Grad? false
Name: Cook, Sam	Score: 0	Grad? false
Name: Cook, Sarah	Score: 0	Grad? false
Name: Cook, Thad	Score: 0	Grad? false
Name: Cook, Thad	Score: 0	Grad? false
Name: Cox, Adrian	Score: 0	Grad? false
Name: Cox, Bob	Score: 0	Grad? false
Name: Cox, Janie	Score: 0	Grad? false
Name: Craig, Janie	Score: 0	Grad? false
Name: Craig, Ryan	Score: 0	Grad? false
Name: Curry, Thad	Score: 0	Grad? false
Name: Dijkstra, Adrian	Score: 0	Grad? false
Name: Edwards, Sandra	Score: 0	Grad? false
Name: Ellis, Adrian	Score: 0	Grad? false
Name: Ellis, Andrew	Score: 0	Grad? false
Name: Ellis, Jamie	Score: 0	Grad? false
Name: Ellis, Lisa	Score: 0	Grad? false
Name: Ellis, Tony	Score: 0	Grad? false
Name: Estrada, Andrew	Score: 0	Grad? false
Name: Figueroa, Sam	Score: 0	Grad? false
Name: Fletcher, Melissa	Score: 0	Grad? false
Name: Fletcher, Ryan	Score: 0	Grad? false
Name: Flowers, Lisa	Score: 0	Grad? false
Name: Flowers, Lisa	Score: 0	Grad? false
Name: Floyd, Adrian	Score: 0	Grad? false
Name: Floyd, Lisa	Score: 0	Grad? false
Name: Francis, Andrew	Score: 0	Grad? false
Name: Francis, Lisa	Score: 0	Grad? false
Name: Freeman, Bob	Score: 0	Grad? false
Name: Freeman, Melissa	Score: 0	Grad? false
Name: Green, Janie	Score: 0	Grad? false
Name: Green, Sarah	Score: 0	Grad? false
Name: Greer, Manny	Score: 0	Grad? false
Name: Hammond, Melissa	Score: 0	Grad? false
Name: Hammond, Sam	Score: 0	Grad? false
Name: Hammond, Sandra	Score: 0	Grad? false
Name: Harris, Thad	Score: 0	Grad? false
Name: Harrison, Melissa	Score: 0	Grad? false
Name: Hawking, Janie	Score: 0	Grad? false
Name: Hawking, Manny	Score: 0	Grad? false
Name: Hawking, Ryan	Score: 0	Grad? false
Name: Hawking, Sarah	Score: 0	Grad? false
Name: Hayes, Adrian	Score: 0	Grad? false
Name: Henderson, Tony	Score: 0	Grad? false
Name: Holmes, Adrian	Score: 0	Grad? false
Name: Holmes, Melissa	Score: 0	Grad? false
Name: Huff, Jane	Score: 0	Grad? false
Name: Huff, Sandra	Score: 0	Grad? false
Name: Huffman, Bob	Score: 0	Grad? false
Name: Huffman, Jamie	Score: 0	Grad? false
Name: Huffman, Janie	Score: 0	Grad? false
Name: Huffman, Janie	Score: 0	Grad? false
Name: Jacobs, Andrew	Score: 0	Grad? false
Name: Jacobs, Tony	Score: 0	Grad? false
Name: Johnston, Bob	Score: 0	Grad? false
Name: Johnston, Thad	Score: 0	Grad? false
Name: Knight, Janie	Score: 0	Grad? false
Name: Knight, Melissa	Score: 0	Grad? false
Name: Lamb, Lisa	Score: 0	Grad? false
Name: Lindsey, Melissa	Score: 0	Grad? false
Name: Love, Lisa	Score: 0	Grad? false
Name: Marshall, Melissa	Score: 0	Grad? false
Name: Martin, Adrian	Score: 0	Grad? false
Name: Martin, Lisa	Score: 0	Grad? false
Name: Massey, Manny	Score: 0	Grad? false
Name: Massey, Ryan	Score: 0	Grad? false
Name: Mcbride, Tony	Score: 0	Grad? false
Name: Mcgee, Adrian	Score: 0	Grad? false
Name: Mcgee, Bob	Score: 0	Grad? false
Name: Mcgee, Sandra	Score: 0	Grad? false
Name: Mullins, Bob	Score: 0	Grad? false
Name: Nelson, Sarah	Score: 0	Grad? false
Name: Newman, Jamie	Score: 0	Grad? false
Name: Newman, Sarah	Score: 0	Grad? false
Name: Newton, Jane	Score: 0	Grad? false
Name: Park, Bob	Score: 0	Grad? false
Name: Park, Jane	Score: 0	Grad? false
Name: Paul, Thad	Score: 0	Grad? false
Name: Perez, Sarah	Score: 0	Grad? false
Name: Powers, Bob	Score: 0	Grad? false
Name: Powers, Jane	Score: 0	Grad? false
Name: Powers, Manny	Score: 0	Grad? false
Name: Price, Ryan	Score: 0	Grad? false
Name: Ramirez, Manny	Score: 0	Grad? false
Name: Ramirez, Sam	Score: 0	Grad? false
Name: Ramirez, Thad	Score: 0	Grad? false
Name: Richards, Manny	Score: 0	Grad? false
Name: Richards, Sarah	Score: 0	Grad? false
Name: Rivera, Thad	Score: 0	Grad? false
Name: Roberson, Jane	Score: 0	Grad? false
Name: Roberson, Lisa	Score: 0	Grad? false
Name: Robinson, Manny	Score: 0	Grad? false
Name: Rodriquez, Lisa	Score: 0	Grad? false
Name: Rodriquez, Tony	Score: 0	Grad? false
Name: Ross, Adrian	Score: 0	Grad? false
Name: Ross, Jane	Score: 0	Grad? false
Name: Ryan, Andrew	Score: 0	Grad? false
Name: Simmons, Melissa	Score: 0	Grad? false
Name: Simmons, Melissa	Score: 0	Grad? false
Name: Simmons, Melissa	Score: 0	Grad? false
Name: Singleton, Adrian	Score: 0	Grad? false
Name: Singleton, Thad	Score: 0	Grad? false
Name: Singleton, Tony	Score: 0	Grad? false
Name: Smith, Ryan	Score: 0	Grad? false
Name: Smith, Tony	Score: 0	Grad? false
Name: Snyder, Manny	Score: 0	Grad? false
Name: Snyder, Melissa	Score: 0	Grad? false
Name: Turing, Sarah	Score: 0	Grad? false
Name: Walsh, Adrian	Score: 0	Grad? false
Name: Walsh, Jamie	Score: 0	Grad? false
Name: Ward, Lisa	Score: 0	Grad? false
Name: Ward, Thad	Score: 0	Grad? false
Name: Ward, Thad	Score: 0	Grad? false
Name: Watson, Lisa	Score: 0	Grad? false
Name: Watson, Ryan	Score: 0	Grad? false
Name: Watts, Jamie	Score: 0	Grad? false
Name: Watts, Sandra	Score: 0	Grad? false
Name: Watts, Sarah	Score: 0	Grad? false
Name: Watts, Tony	Score: 0	Grad? false
Name: Wheeler, Thad	Score: 0	Grad? false
Name: Williams, Adrian	Score: 0	Grad? false
Name: Willis, Janie	Score: 0	Grad? false
Name: Willis, Janie	Score: 0	Grad? false
Name: Alexander, Janie	Score: 1	Grad? false
Name: Allison, Melissa	Score: 1	Grad? false
Name: Allison, Sarah	Score: 1	Grad? false
Name: Allison, Tony	Score: 1	Grad? false
Name: Ball, Jane	Score: 1	Grad? false
Name: Ball, Lisa	Score: 1	Grad? false
Name: Ball, Thad	Score: 1	Grad? false
Name: Barnett, Sam	Score: 1	Grad? false
Name: Benson, Manny	Score: 1	Grad? false
Name: Black, Tony	Score: 1	Grad? false
Name: Boole, Janie	Score: 1	Grad? false
Name: Cain, Janie	Score: 1	Grad? false
Name: Cain, Sandra	Score: 1	Grad? false
Name: Carpenter, Bob	Score: 1	Grad? false
Name: Carpenter, Jamie	Score: 1	Grad? false
Name: Carson, Ryan	Score: 1	Grad? false
Name: Chambers, Lisa	Score: 1	Grad? false
Name: Chambers, Thad	Score: 1	Grad? false
Name: Cook, Jane	Score: 1	Grad? false
Name: Cook, Lisa	Score: 1	Grad? false
Name: Cook, Sam	Score: 1	Grad? false
Name: Cook, Thad	Score: 1	Grad? false
Name: Cortez, Adrian	Score: 1	Grad? false
Name: Cortez, Jamie	Score: 1	Grad? false
Name: Cortez, Sam	Score: 1	Grad? false
Name: Cox, Jamie	Score: 1	Grad? false
Name: Cox, Melissa	Score: 1	Grad? false
Name: Cox, Ryan	Score: 1	Grad? false
Name: Craig, Bob	Score: 1	Grad? false
Name: Craig, Sarah	Score: 1	Grad? false
Name: Craig, Thad	Score: 1	Grad? false
Name: Cruz, Ryan	Score: 1	Grad? false
Name: Curry, Sandra	Score: 1	Grad? false
Name: Curry, Thad	Score: 1	Grad? false
Name: Dixon, Bob	Score: 1	Grad? false
Name: Dixon, Janie	Score: 1	Grad? false
Name: Dixon, Manny	Score: 1	Grad? false
Name: Edwards, Janie	Score: 1	Grad? false
Name: Edwards, Sandra	Score: 1	Grad? false
Name: Estrada, Manny	Score: 1	Grad? false
Name: Estrada, Manny	Score: 1	Grad? false
Name: Fernandez, Adrian	Score: 1	Grad? false
Name: Fernandez, Andrew	Score: 1	Grad? false
Name: Fields, Bob	Score: 1	Grad? false
Name: Fletcher, Jamie	Score: 1	Grad? false
Name: Fletcher, Sam	Score: 1	Grad? false
Name: Fletcher, Tony	Score: 1	Grad? false
Name: Fletcher, Tony	Score: 1	Grad? false
Name: Flowers, Manny	Score: 1	Grad? false
Name: Floyd, Melissa	Score: 1	Grad? false
Name: Francis, Sandra	Score: 1	Grad? false
Name: Frank, Bob	Score: 1	Grad? false
Name: Frank, Sandra	Score: 1	Grad? false
Name: Freeman, Jane	Score: 1	Grad? false
Name: Freeman, Sarah	Score: 1	Grad? false
Name: Garcia, Sandra	Score: 1	Grad? false
Name: Grant, Lisa	Score: 1	Grad? false
Name: Greer, Thad	Score: 1	Grad? false
Name: Hammond, Manny	Score: 1	Grad? false
Name: Hammond, Melissa	Score: 1	Grad? false
Name: Harris, Tony	Score: 1	Grad? false
Name: Hawking, Janie	Score: 1	Grad? false
Name: Hawkins, Tony	Score: 1	Grad? false
Name: Hayes, Sandra	Score: 1	Grad? false
Name: Hayes, Thad	Score: 1	Grad? false
Name: Henry, Jamie	Score: 1	Grad? false
Name: Henry, Ryan	Score: 1	Grad? false
Name: Hernandez, Andrew	Score: 1	Grad? false
Name: Hernandez, Jane	Score: 1	Grad? false
Name: Hernandez, Manny	Score: 1	Grad? false
Name: Hernandez, Manny	Score: 1	Grad? false
Name: Hernandez, Melissa	Score: 1	Grad? false
Name: Holmes, Adrian	Score: 1	Grad? false
Name: Holmes, Andrew	Score: 1	Grad? false
Name: Holmes, Manny	Score: 1	Grad? false
Name: Huff, Lisa	Score: 1	Grad? false
Name: Huff, Ryan	Score: 1	Grad? false
Name: Huffman, Bob	Score: 1	Grad? false
Name: Huffman, Jane	Score: 1	Grad? false
Name: Hunt, Jane	Score: 1	Grad? false
Name: Hunt, Sarah	Score: 1	Grad? false
Name: Jacobs, Sam	Score: 1	Grad? false
Name: Johnston, Manny	Score: 1	Grad? false
Name: Johnston, Sandra	Score: 1	Grad? false
Name: Johnston, Thad	Score: 1	Grad? false
Name: Lamb, Janie	Score: 1	Grad? false
Name: Lowe, Andrew	Score: 1	Grad? false
Name: Lowe, Tony	Score: 1	Grad? false
Name: Marshall, Melissa	Score: 1	Grad? false
Name: Massey, Sam	Score: 1	Grad? false
Name: Mcbride, Janie	Score: 1	Grad? false
Name: Mcgee, Janie	Score: 1	Grad? false
Name: Mclaughlin, Thad	Score: 1	Grad? false
Name: Nelson, Manny	Score: 1	Grad? false
Name: Newman, Ryan	Score: 1	Grad? false
Name: Norman, Andrew	Score: 1	Grad? false
Name: Park, Andrew	Score: 1	Grad? false
Name: Patrick, Adrian	Score: 1	Grad? false
Name: Patrick, Sam	Score: 1	Grad? false
Name: Paul, Sam	Score: 1	Grad? false
Name: Price, Adrian	Score: 1	Grad? false
Name: Price, Janie	Score: 1	Grad? false
Name: Price, Manny	Score: 1	Grad? false
Name: Ramirez, Janie	Score: 1	Grad? false
Name: Ramirez, Thad	Score: 1	Grad? false
Name: Rios, Manny	Score: 1	Grad? false
Name: Rios, Melissa	Score: 1	Grad? false
Name: Rios, Sandra	Score: 1	Grad? false
Name: Roberson, Sarah	Score: 1	Grad? false
Name: Roberson, Sarah	Score: 1	Grad? false
Name: Robinson, Janie	Score: 1	Grad? false
Name: Robinson, Manny	Score: 1	Grad? false
Name: Rodriquez, Bob	Score: 1	Grad? false
Name: Rogers, Sandra	Score: 1	Grad? false
Name: Ross, Adrian	Score: 1	Grad? false
Name: Ryan, Sam	Score: 1	Grad? false
Name: Ryan, Sam	Score: 1	Grad? false
Name: Ryan, Sarah	Score: 1	Grad? false
Name: Simmons, Melissa	Score: 1	Grad? false
Name: Simon, Lisa	Score: 1	Grad? false
Name: Singleton, Sandra	Score: 1	Grad? false
Name: Singleton, Thad	Score: 1	Grad? false
Name: Smith, Jamie	Score: 1	Grad? false
Name: Smith, Sandra	Score: 1	Grad? false
Name: Snyder, Adrian	Score: 1	Grad? false
Name: Snyder, Ryan	Score: 1	Grad? false
Name: Sutton, Sam	Score: 1	Grad? false
Name: Thornton, Lisa	Score: 1	Grad? false
Name: Turing, Andrew	Score: 1	Grad? false
Name: Turing, Bob	Score: 1	Grad? false
Name: Walker, Sarah	Score: 1	Grad? false
Name: Walker, Thad	Score: 1	Grad? false
Name: Ward, Manny	Score: 1	Grad? false
Name: Ward, Tony	Score: 1	Grad? false
Name: Watson, Jane	Score: 1	Grad? false
Name: Watson, Janie	Score: 1	Grad? false
Name: Watts, Andrew	Score: 1	Grad? false
Name: Wheeler, Sarah	Score: 1	Grad? false
Name: Williams, Andrew	Score: 1	Grad? false
Name: Williams, Sandra	Score: 1	Grad? false
Name: Willis, Andrew	Score: 1	Grad? false
Name: Willis, Sam	Score: 1	Grad? false
Name: Wood, Sandra	Score: 1	Grad? false
Name: Allen, Adrian	Score: 2	Grad? false
Name: Allen, Adrian	Score: 2	Grad? false
Name: Allison, Andrew	Score: 2	Grad? false
Name: Allison, Bob	Score: 2	Grad? false
Name: Ball, Bob	Score: 2	Grad? false
Name: Barnett, Adrian	Score: 2	Grad? false
Name: Barnett, Melissa	Score: 2	Grad? false
Name: Benson, Jamie	Score: 2	Grad? false
Name: Benson, Ryan	Score: 2	Grad? false
Name: Boole, Lisa	Score: 2	Grad? false
Name: Buchanan, Sandra	Score: 2	Grad? false
Name: Buchanan, Sarah	Score: 2	Grad? false
Name: Bush, Adrian	Score: 2	Grad? false
Name: Cain, Lisa	Score: 2	Grad? false
Name: Carpenter, Jamie	Score: 2	Grad? false
Name: Carpenter, Melissa	Score: 2	Grad? false
Name: Carson, Sandra	Score: 2	Grad? false
Name: Chandler, Jamie	Score: 2	Grad? false
Name: Cook, Adrian	Score: 2	Grad? false
Name: Cook, Adrian	Score: 2	Grad? false
Name: Cook, Lisa	Score: 2	Grad? false
Name: Cortez, Adrian	Score: 2	Grad? false
Name: Cortez, Lisa	Score: 2	Grad? false
Name: Cortez, Melissa	Score: 2	Grad? false
Name: Cortez, Ryan	Score: 2	Grad? false
Name: Cortez, Thad	Score: 2	Grad? false
Name: Cox, Ryan	Score: 2	Grad? false
Name: Craig, Jane	Score: 2	Grad? false
Name: Craig, Lisa	Score: 2	Grad? false
Name: Craig, Ryan	Score: 2	Grad? false
Name: Cruz, Adrian	Score: 2	Grad? false
Name: Cruz, Jane	Score: 2	Grad? false
Name: Cruz, Sandra	Score: 2	Grad? false
Name: Dijkstra, Jamie	Score: 2	Grad? false
Name: Dijkstra, Janie	Score: 2	Grad? false
Name: Edwards, Sarah	Score: 2	Grad? false
Name: Estrada, Sandra	Score: 2	Grad? false
Name: Fields, Andrew	Score: 2	Grad? false
Name: Fields, Bob	Score: 2	Grad? false
Name: Fletcher, Manny	Score: 2	Grad? false
Name: Fletcher, Melissa	Score: 2	Grad? false
Name: Fletcher, Ryan	Score: 2	Grad? false
Name: Fletcher, Sam	Score: 2	Grad? false
Name: Flowers, Ryan	Score: 2	Grad? false
Name: Floyd, Adrian	Score: 2	Grad? false
Name: Floyd, Ryan	Score: 2	Grad? false
Name: Floyd, Sarah	Score: 2	Grad? false
Name: Francis, Andrew	Score: 2	Grad? false
Name: Frank, Manny	Score: 2	Grad? false
Name: Frank, Melissa	Score: 2	Grad? false
Name: Frank, Ryan	Score: 2	Grad? false
Name: Frank, Ryan	Score: 2	Grad? false
Name: Garcia, Sandra	Score: 2	Grad? false
Name: Grant, Lisa	Score: 2	Grad? false
Name: Grant, Melissa	Score: 2	Grad? false
Name: Grant, Sarah	Score: 2	Grad? false
Name: Green, Bob	Score: 2	Grad? false
Name: Green, Ryan	Score: 2	Grad? false
Name: Harris, Sam	Score: 2	Grad? false
Name: Harrison, Sam	Score: 2	Grad? false
Name: Harrison, Tony	Score: 2	Grad? false
Name: Hawkins, Melissa	Score: 2	Grad? false
Name: Hawkins, Tony	Score: 2	Grad? false
Name: Hayes, Janie	Score: 2	Grad? false
Name: Henderson, Janie	Score: 2	Grad? false
Name: Henderson, Lisa	Score: 2	Grad? false
Name: Henderson, Thad	Score: 2	Grad? false
Name: Henry, Jamie	Score: 2	Grad? false
Name: Hernandez, Lisa	Score: 2	Grad? false
Name: Hernandez, Lisa	Score: 2	Grad? false
Name: Holmes, Lisa	Score: 2	Grad? false
Name: Huff, Adrian	Score: 2	Grad? false
Name: Huff, Lisa	Score: 2	Grad? false
Name: Huffman, Adrian	Score: 2	Grad? false
Name: Huffman, Sam	Score: 2	Grad? false
Name: Hunt, Andrew	Score: 2	Grad? false
Name: Jacobs, Bob	Score: 2	Grad? false
Name: Johnston, Ryan	Score: 2	Grad? false
Name: Johnston, Sarah	Score: 2	Grad? false
Name: Lindsey, Sam	Score: 2	Grad? false
Name: Lowe, Adrian	Score: 2	Grad? false
Name: Lowe, Manny	Score: 2	Grad? false
Name: Lowe, Ryan	Score: 2	Grad? false
Name: Marshall, Lisa	Score: 2	Grad? false
Name: Martin, Jane	Score: 2	Grad? false
Name: Martin, Thad	Score: 2	Grad? false
Name: Massey, Jamie	Score: 2	Grad? false
Name: Mcbride, Andrew	Score: 2	Grad? false
Name: Mcbride, Ryan	Score: 2	Grad? false
Name: Mcgee, Tony	Score: 2	Grad? false
Name: Mclaughlin, Bob	Score: 2	Grad? false
Name: Mclaughlin, Manny	Score: 2	Grad? false
Name: Mclaughlin, Ryan	Score: 2	Grad? false
Name: Nelson, Lisa	Score: 2	Grad? false
Name: Nelson, Sandra	Score: 2	Grad? false
Name: Nelson, Thad	Score: 2	Grad? false
Name: Newman, Bob	Score: 2	Grad? false
Name: Newman, Ryan	Score: 2	Grad? false
Name: Newton, Lisa	Score: 2	Grad? false
Name: Norman, Adrian	Score: 2	Grad? false
Name: Obrien, Sandra	Score: 2	Grad? false
Name: Park, Janie	Score: 2	Grad? false
Name: Patrick, Sam	Score: 2	Grad? false
Name: Patrick, Sarah	Score: 2	Grad? false
Name: Patrick, Sarah	Score: 2	Grad? false
Name: Paul, Jamie	Score: 2	Grad? false
Name: Paul, Sam	Score: 2	Grad? false
Name: Paul, Sam	Score: 2	Grad? false
Name: Perez, Janie	Score: 2	Grad? false
Name: Powers, Adrian	Score: 2	Grad? false
Name: Powers, Manny	Score: 2	Grad? false
Name: Price, Manny	Score: 2	Grad? false
Name: Price, Sandra	Score: 2	Grad? false
Name: Ramirez, Adrian	Score: 2	Grad? false
Name: Richards, Manny	Score: 2	Grad? false
Name: Richards, Manny	Score: 2	Grad? false
Name: Richards, Melissa	Score: 2	Grad? false
Name: Rios, Janie	Score: 2	Grad? false
Name: Rios, Janie	Score: 2	Grad? false
Name: Rios, Thad	Score: 2	Grad? false
Name: Rivera, 